%%%%%%%%%%%%%%%%%%%%%%%%%%%%
%............%%............%
%.%%%%.%%%%%.%%.%%%%%.%%%%.%
%.%%%%.%%%%%.%%.%%%%%.%%%%.%
%.%%%%.%%%%%.%%.%%%%%.%%%%.%
%..........................%
%.%%%%.%%.%%%%%%%%.%%.%%%%.%
%.%%%%.%%.%%%%%%%%.%%.%%%%.%
%......%%....%%....%%......%
%%%%%%.%%%%% %% %%%%%.%%%%%%
%    %.%%%%% %% %%%%%.%    %
%    %.%%          %%.%    %
%    %.%% %%%  %%% %%.%    %
%%%%%%.%% %      % %%.%%%%%%
%     .   % GGGG %   .     %
%%%%%%.%% %      % %%.%%%%%%
%    %.%% %%%%%%%% %%.%    %
%    %.%%          %%.%    %
%    %.%% %%%%%%%% %%.%    %
%%%%%%.%% %%%%%%%% %%.%%%%%%
%............%%............%
%.%%%%.%%%%%.%%.%%%%%.%%%%.%
%.%%%%.%%%%%.%%.%%%%%.%%%%.%
%...%%........P.......%%...%
%%%.%%.%%.%%%%%%%%.%%.%%.%%%
%%%.%%.%%.%%%%%%%%.%%.%%.%%%
%......%%....%%....%%......%
%.%%%%%%%%%%.%%.%%%%%%%%%%.%
%.%%%%%%%%%%.%%.%%%%%%%%%%.%
%..........................%
%%%%%%%%%%%%%%%%%%%%%%%%%%%%
